{
  "name": "map1",
  "width": 10,
  "height": 10,
  "tileWidth": 256,
  "tileHeight": 128,
  "tileSet": "dungeon",
  "layers": [
    {
      "name": "main",
      "data": [
        1,  2,  3,  4,  1,  1,  3,  4,  1,  2,
        4,  12, 5,  6,  7,  8,  5,  6, 11,  3,
        2,  5,  8, 48,  6,  5,  8,  7, 47,  3,
        1,  6,  5,  6,  7,  7,  5,  8,  5,  2,
        4,  7,  5,  5,  5,  5,  5,  5, 20,  3,
        2,  6,  5,  6,  5,  8,  6,  6,  5,  3,
        1,  5, 46,  6,  7,  7,  5,  5,  8,  2,
        4,  6,  5,  6,  6,  6,  5,  6, 18,  3,
        2, 10, 48,  6,  7,  8,  5,  6,  9,  3,
        1,  2,  3,  4,  1,  1,  3,  4,  2,  1
      ]
    }
  ]
}
